111111111111111111111
000000000000000000001
111111111111111111101
100000000000000000001
101111111111111111111
100000000000000000001
111111111111111111101
100000000000000000001
101111111111111111111
10000000000000000000X
111111111111111111111